111111111111111111111111111111111
100000000000000010000000010001001
100000001000000000000110000000001
100001100000110000010000001000001
100000000000000000000000001000001
100100000000000010000010000000001
100000100000010000000100001000001
100000000000000000000000000010001
110001001100001100110100000111101
111001111110011111111111011111111
111111111111111111111111111111111
111111111111111111111111111111111
